10 0 0 0 0 0 0 0
0  0 0 0 0 0 0 0
10
0  0 0 1
10 0 0 9
0
10 0 0 10
0  0 0 0   0 0 0 0 8 0 0 0 1
10 0 0 10  0 0 0 0 1 1
10 0 0 10  0 0 0 5 0 0
0  0 0 10  3 0 1 0 1 1
10 0 0 10 0 0 0 0 0 0 0 0 0 0 0 0 0 0 0 0 0 0 0 0 0 1   1   1   1   1 6 7 8
0  0 0 10 0 0 0 0 0 0 0 0 0 0 0 0 0 0 0 0 0 0 0 0 0 10  10  10  10  10
10 0 0 0  0 0 0 0 0 0 0 0 0 0 0 0 0 0 0 0 0 0 0 0 1 10  10  10  10  10
10  1 1 1 1 1 1 1 1 1 5 1 1 1 1 1 1 1 1 1 1 1 1 1 1 10  10  10  10

#1 số 0 là khoảng cách giá trị 95px, hàng trên cách dưới 50px