0 0 0 0 0 0 0 0
0 0 0 0 0 0 0 0
0 0 0 9 0 8 0 7 0
0 0 0 0 0 0 0 6 0 0 5
0 0 0 0 3 0 2 0 1
0 0 0 4 0 0 0 1
1 1 1 1 1 1 1 1 1 1 5 1 1 1 1 1 1

#1 số 0 là khoảng cách giá trị 100px