0 0 0 0 0 0 0 0
0 0 0 0 0 0 0 0
0
0
0
0 0 0 9 0 8 0 0
0 0 0 0 0 0 0 0 0
0 0 0 0 0 0 0 5
0 0 0 0 3 0 2 0 1
0
10 4 0 4 0 0 2 1
0
1 1 1 1 1 1 1 1 1 1 5 1 1 1 1 1 1

#1 số 0 là khoảng cách giá trị 100px, hàng trên cách dưới 50px